//Tags
Tag dairyTag = new TagImpl(“Dairy”);
Tag meatTag = new TagImpl(“Meat”);
Tag kosherTag = new TagImpl(“Non-Kosher”);
Tag halalTag = new TagImpl(“Non-Halal”);
Tag glutenTag = new TagImpl(“Gluten’);

//Ingredients
Ingredient beef = new IngredientImpl(“Beef”, Collections.singletonList(meatTag));
Ingredient salt = new IngredientImpl(“Salt”);
Ingredient blackPepper = new IngredientImpl(“Black Pepper”);
Ingredient oliveOil = new IngredientImpl(“Olive Oil”);
Ingredient italianSeasoning = new IngredientImpl(“Italian Seasoning”);
Ingredient garlic = new IngredientImpl(“Garlic”);
Ingredient butter = new IngredientImpl(“Butter”, Collections.singletonList(dairyTag));
Ingredient eggs = new IngredientImpl(“Egg”);
Ingredient cheese = new IngredientImpl(“Cheese”, Collections.singletonList(dairyTag));
Ingredient oregano = new IngredientImpl(“Oregano”);
Ingredient bread = new IngredientImpl(“Bread”, Collections.singletonList(gluten));
Ingredient tomato = new IngredientImpl(“Tomato”);
Ingredient turkeyBreastSlice = new IngredientImpl(“Turkey Breast Slice”, Collections.singletonList(meatTag));
Ingredient cheeseSlice = new IngredientImpl(“Cheese Slice”, Collections.singletonList(dairyTag));
Ingredient mayo = new IngredientImpl(“Mayo”, Collections.singletonList(dairyTag));
Ingredient lettuce = new IngredientImpl(“Lettuce”);
Ingredient bacon = new IngredientImpl(“Bacon”, new Collection<Tag>(kosherTag, halalTag));
Ingredient croutons = new IngredientImpl(“Croutons”, Collections.singletonList(glutenTag));
Ingredient caesarDressing = new IngredientImpl(“Caesar Dressing”);
Ingredient bagel = new IngredientImpl(“Bagel”, Collections.singletonList(glutenTag));
Ingredient creamCheese = new IngredientImpl(“Cream Cheese”, Collections.singletonList(dairyTag));


//RecipeItems
RecipeItem beefForSteak = new MassRecipeItem(beef, 200, false);
RecipeItem pinchOfSaltForSteak = new QuantityRecipeItem(salt, 2, false);
RecipeItem pinchOfBlackPepperForSteak = new QuantityRecipeItem(blackPepper, 5, false);
RecipeItem oliveOilForSteak = new VolumetricRecipeItem(oliveOil, 15, false);
RecipeItem pinchOfItalianSeasoningForSteak = new QuantityRecipeItem(italianSeasoning, 2, false);
RecipeItem garlicForSteak = new QuantityRecipeItem(garlic, 1, false);
RecipeItem butterForSteak = new QuantityRecipeItem(butter, 50, false);

RecipeItem eggsForOmelette = new QuantityRecipeItem(egg, 2, false);
RecipeItem butterForOmelette = new QuantityRecipeItem(butter, 20, false);
RecipeItem cheeseForOmelette = new MassRecipeItem(cheese, 50, true);
RecipeItem saltForOmelette = new QuantityRecipeItem(salt, 2, true);
RecipeItem oreganoForOmelette = new QuantityRecipeItem(oregano, 2, false);

RecipeItem breadForTurkeyBLT = new QuantityRecipeItem(bread, 2, false);
RecipeItem tomatoForTurkeyBLT = new QuantityRecipeItem(tomato, 0.5, false);
RecipeItem cheeseSlicesForTurkeyBLT = new QuantityRecipeItem(cheeseSlice, 1, true);
RecipeItem mayoForTurkeyBLT = new VolumetricRecipeItem(mayo, 15, false);
RecipeItem turkeyBreastSliceForTurkeyBLT = new QuantityRecipeItem(turkeyBreastSlice, 4, false);
RecipeItem baconForTurkeyBLT = new QuantityRecipeItem(bacon, 8, false);
RecipeItem lettuceForTurkeyBLT = new MassRecipeItem(lettuce, 30, false);

RecipeItem lettuceForCaesarSalad = new MassRecipeItem(lettuce, 200, false);
RecipeItem croutonsForCaesarSalad = new MassRecipeItem(croutons, 20, false);
RecipeItem caesarDressingForCaesarSalad = new VolumetricRecipeItem(caesarDressing, 40, false);

RecipeItem creamCheeseForCreamCheeseBagel = new VolumetricRecipeItem(creamCheese, 2, false);
RecipeItem bagelForCreamCheeseBagel = new QuantityRecipeItem(bagel, 1, false);

//Instructions
List<String> steakInstructions = new ArrayList<>(“1. Season steaks with salt and pepper on both sides, and rub them all over with oil.”, “2. Heat a grill pan over high heat and cook the steaks until browned on one side, about 2 to 3 minutes.”, “3. Flip steaks and cook on the other side until just browned, about 2 to 3 minutes. Don’t overcook, or you'll run the risk of toughening the meat.”, “4. Remove steaks to plates to let the meat rest. Turn off the heat and add 2 tablespoons butter to the skillet to melt.”, “5. Drizzle the melted butter and juices from the skillet on the steaks.”, “Adapted from: https://www.thespruceeats.com/steak-medley-date-night-meal-912501”);

List<String> omeletteInstructions = new ArrayList<>(“1. Crack two eggs into bowl.”, “2. Grate cheese into separate bowl.”, “3. Add cheese, salt, and pinch of oregano into bowl with eggs.”, “3. Throughly beat eggs until uniform.”, “4. Pour egg mix into frying pan on medium heat until bottom is light-golden.”, “5. Flip omelette and fry until light-golden.”);

List<String> turkeyBLTInstructions = new ArrayList<>(“1. Spread mayo onto one slice of bread”, “2. Cut lettuce into thin slices, cut and wash.”, “3. Pile the ingredients in the following order: cheese, turkey breast, bacon, lettuce, other slice of bread.”);

List<String> caesarSaladInstructions = new ArrayList<>(“2. Cut lettuce into thin slices, wash, and dry.”, “2. Put lettuce into bowl, and add croutons and dressing.”, “3. Mix well.”);

List<String> creamCheeseBagelInstructions = new ArrayList<>(“1. Cut bagel into two, and toast to light golden-brown.”, “2. Spread cream cheese onto bagel slices.”);


//RecipeItemList
List<RecipeItem> steakRecipeItems = new ArrayList<>(beefForSteak, pinchOfSaltForSteak, pinchOfBlackPepperForSteak, oliveOilForSteak, pinchOfItalianSeasoningForSteak, garlicForSteak, butterForSteak);

List<RecipeItem> omeletteRecipeItems = new ArrayList<>(eggsForOmelette, butterForOmelette, cheeseForOmelette, saltForOmelette, oreganoForOmelette);

List<RecipeItem> turkeyBLTRecipeItems = new ArrayList<>(breadForTurkeyBLT, tomatoForTurkeyBLT, cheeseSlicesForTurkeyBLT, mayoForTurkeyBLT, turkeyBreastSliceForTurkeyBLT, baconForTurkeyBLT, lettuceForTurkeyBLT);

List<RecipeItem> caesarSaladRecipeItems = new ArrayList<>(lettuceForCaesarSalad, croutonsForCaesarSalad, caesarDressingForCaesarSalad);

List<RecipeItem> creamCheeseBagelRecipeItems = new ArrayList<>(creamCheeseForCreamCheeseBagel, bagelForCreamCheeseBagel);

//Recipes
Recipe steak = new RecipeImpl(“Steak”, “A delicious serving of steak for one.”, steakInstructions, steakRecipeItems);

Recipe omelette = new RecipeImpl(“Omelette”, “A classic omelette with light seasoning and cheese.”, omeletteInstructions, omeletteRecipeItems);

Recipe turkeyBLT = new RecipeImpl(“Turkey BLT”, “A classic sandwich that everyone loves”, turkeyBLTInstructions, turkeyBLTRecipeItems);

Recipe caesarSalad = new RecipeImpl(“Caesar Salad”, “A solid side-salad for any good meal”, caesarSaladInstructions, caesarSaladRecipeItems);

Recipe creamCheeseBagel = new RecipeImpl(“Cream Cheese Bagel”, “A solid midnight snack”, creamCheeseBagelInstructions, creamCheeseRecipeItems);
